1111111111111111
1001101101000001
1000P0000000E001
10000000C0000001
1010101000100001
1111111111111111