11111111111111
101001010011C1
1P000000000011
1E000000000001
10100100101011
11111111111111